{
    "maze":[["0", "0", "0", "0", "0", "0", "0", "0", "0", "0", "0", "0", "0", "0", "0"],
            ["0", "1", "1", "1", "0", "0", "1", "1", "1", "1", "0", "0", "0", "1", "0"],
            ["0", "1", "0", "1", "1", "1", "1", "0", "0", "0", "0", "1", "1", "1", "0"],
            ["0", "1", "0", "0", "0", "1", "0", "0", "0", "0", "1", "1", "0", "0", "0"],
            ["0", "0", "0", "1", "1", "1", "1", "1", "1", "0", "1", "0", "0", "0", "0"],
            ["0", "0", "0", "1", "0", "1", "0", "0", "1", "1", "1", "1", "1", "1", "0"],
            ["0", "1", "0", "0", "0", "1", "1", "0", "0", "1", "0", "0", "0", "1", "0"],
            ["0", "1", "0", "0", "0", "0", "1", "1", "1", "1", "0", "1", "0", "1", "0"],
            ["0", "1", "0", "1", "0", "0", "1", "0", "0", "0", "0", "1", "1", "1", "1"],
            ["0", "1", "1", "1", "1", "1", "1", "0", "0", "0", "0", "1", "0", "0", "0"],
            ["0", "0", "1", "0", "1", "0", "0", "1", "1", "1", "1", "1", "0", "0", "0"],
            ["0", "1", "1", "0", "0", "0", "0", "0", "0", "1", "0", "0", "1", "1", "0"],
            ["0", "1", "0", "1", "1", "1", "0", "0", "1", "1", "1", "0", "0", "1", "0"],
            ["0", "1", "1", "1", "0", "1", "1", "1", "1", "0", "1", "1", "1", "1", "0"],
            ["0", "0", "0", "0", "0", "0", "0", "0", "0", "0", "0", "0", "0", "0", "0"]],
    "Guardian pos": [14, 8],
    "Player pos": [2, 1],
    "Sprite size": [40, 40]
}